#######
#S    #
# ### #
#   # #
# #   #
#   # #
####  E
